2 22 22
######################
#x    *     p  *     #
#  * *  *     #*  *# #
#  *  ## * * * # #*  #
##   **# x  *   b    #
#*  # **** *   * f # #
#* * *# **  *# * #   #
#  f # #  b  #   #***#
# #   #*  *  #* *  **#
#*      * * ##  # #  #
#*  *  #*  *   *  * *#
#  * # *   x#  f  *  #
######################