2 13 31
###############################
#p * *    4   *  ** * *  2   *#
# # #*# #*# # #*# # # # # #*# #
#    ******x***   2  *    **  #
# #*# # # # # # #b# #*# # # #*#
#   3      *     **  *   *  **#
# # #*# # # # # #*#*#*#*# # # #
#   *   4    *   * *x* *      #
# # # # #*# # # # # #*#*# #*# #
#   ****      4  *   *   3    #
# # # # # # # # # #*#*# # # #*#
#  ** *   *   1******   2     #
###############################