2 13 31
###############################
#p * *    1   *  ** * *  2   *#
# # # # #*# # #*# # # # # #*# #
#    * * *** **      *    **  #
# #*# # # # # # #b# # # # # #*#
#          *     **      *  **#
# # #*# # # # # #*#*#*#*# # # #
#   *        *   * *x* *      #
# # # # #*# # # # # # #*# #*# #
#   ****      4  *       3    #
# # # # # # # # # #*# # # # #*#
#  ** *   *   1         2     #
###############################